999999999999999999999999999
9        3                9
9                         9
9                         9
9      3                  9
93                        9
9                         9
9                         9
9                         9
9                         9
9             3           9
9                         9
9                         9
9                         9
9      3                  9
9                         9
9                         9
9                         9
9                         9
9                         9
9                         9
9                         9
9                   3     9
9                         9
9         3               9
9                         9
9                         9
9                         9
9                         9
9               3         9
9                         9
999999999999999999999999999
