111111111111111111111111111
133333333333313333333333331
131111311111313111113111131
141  131   13131   131  141
131111311111313111113111131
133333333333333333333333331
131111311311111113113111131
131111311311111113113111131
133333311333313333113333331
111111311111 1 111113111111
     1311111 1 1111131     
     1311         1131     
     1311 1199911 1131     
111111311 1     1 113111111
      3   1     1   3      
      3   1     1   3      
111111311 1     1 113111111
     1311 1111111 1131     
     1311         1131     
     1311 1111111 1131     
111111311 1111111 113111111
133333333333313333333333331
131111311111313111113111131
131111311111313111113111131
1433113333333 3333333113341
111311311311111113113113111
111311311311111113113113111
133333311333313333113333331
131111111111313111111111131
131111111111313111111111131
133333333333333333333333331
111111111111111111111111111
